 $$$$$$$  
 $     $$$
$$O$$$   $
$    P O $
$  !$ O $$
$$!!$   $ 
 $$$$$$$$ 
last record: